################################
#..............................#
#..............................#
#..............................#
#..........#######.............#
#..............................#
#....#####..........#####......#
#..............................#
#..P...........................#
################################
