################################
#..............................#
#..............................#
#..............................#
#..#####.......................#
#..........########............#
#...................#####......#
#......##########..............#
#..P...........................#
################################
